there are|you will find|you'll find|you can find|you will discover|there are actually
a large|a sizable|a big
amount|quantity
so many|a lot of|numerous|countless|a great number of|lots of
a lot|a great deal|a whole lot|a good deal|quite a bit|lots
a variety of|a number of|many different|various|a range of|several different
benefits|advantages|rewards|positive aspects|added benefits
a number of|numerous|several|quite a few|a variety of|many
advantages|benefits|positive aspects
one|1|a single|one particular
at some point|sooner or later
in the|within the|inside the
those who|those that|people who|individuals who|people that
of the|from the|in the|on the|with the|of your
have the|possess the
to get|to obtain|to acquire|to have
yourself|your self|oneself
up to|as much as
to make|to create|to produce
united states|united states of america|usa
computer|pc|personal computer|laptop|computer system|laptop or computer
pc|computer
with the|using the|with all the|together with the
money|cash|funds|income|dollars|revenue
enough|sufficient|adequate
manage|handle
pay|spend
find|discover|locate|uncover|come across|obtain
the money|the cash
working|operating|functioning
example|instance
to the|towards the|for the
great|fantastic|excellent|wonderful|good|terrific
really|truly|actually|genuinely|seriously|definitely
fact|reality|truth
you should|you need to|you ought to|you must|it is best to|you'll want to
shouldn't|should not
will not|won't|is not going to
won't|will not
we will|we'll|we are going to
be able to|have the ability to|be capable of
we can|we are able to
take a look at|check out|have a look at
try|attempt
check|verify
mistake|error
choice|option|selection|decision
to choose from|to select from
choose|select|pick|decide on|opt for|pick out
between|in between|among|amongst|involving
to give|to provide|to offer
explain|clarify
to provide|to supply
they may|they might
they can|they are able to|they're able to|they could|they will
they are|they're|they may be
able|in a position|capable
they don't|they do not
seem|appear|look
to be|to become
aren't|are not
large|big|huge|massive|substantial|significant
pretty|fairly|quite
big|large|huge|massive|major|significant
fairly|pretty|relatively
there is|there's|there is certainly
something|some thing|one thing|anything|a thing
there's|there is
the secret|the key
the most|probably the most|essentially the most|one of the most|by far the most
that you are|that you're
you're|you are|you happen to be
that you|that you simply|which you|that you just
that they are|that they're
they're|they are
they will|they'll|they are going to|they're going to|they may
makes|tends to make
ads|advertisements
tv|television
television|tv
top|leading|best|prime|top rated|major
range|variety
many|numerous|several|a lot of|quite a few|lots of
yet|however|but
it's|it is|it really is
i am|i'm
i'm|i am
in a|inside a|within a
similar|comparable|equivalent|related
fashion|style
this is|this really is|this can be|that is
if so|if that's the case|in that case
that is|that's|which is|that is certainly|that is definitely|that may be
i will|i'll
have a|possess a
tend|have a tendency
at the same time|simultaneously
reason|purpose|cause|explanation
that's|that is
do not|don't|usually do not
don't|do not|never
worry|be concerned
world|globe|planet
fantastic|great|wonderful|amazing|excellent|superb
incredible|extraordinary|amazing|outstanding|unbelievable|remarkable
at the|in the
night|evening
whilst|while
while|whilst|although|even though|when|though
means|indicates|implies|signifies|suggests
may|might|could|may possibly|may well|may perhaps
home|house|residence|property|household|dwelling
work|function|perform|operate
business|company|enterprise|organization|small business|business enterprise
make money|earn money|generate income|generate profits
look|appear
right|correct|proper|appropriate|suitable|ideal
to use|to make use of|to utilize|to work with
direction|path
on the|around the
well|nicely|effectively|properly
in this|within this
these days|nowadays|today|as of late|lately|in recent times
nowadays|these days|today|presently|currently
same|exact same|identical|very same|similar
the same|exactly the same|the identical|precisely the same|the exact same
wrong|incorrect
live|reside
tell|inform
professional|expert|skilled|specialist|qualified|experienced
treatment|therapy|remedy
put|place
of your|of one's|of the
mind|thoughts
forget|neglect|overlook
remember|keep in mind|bear in mind|don't forget|recall|try to remember
think|believe|feel|consider|assume
imagine|envision|picture|think about|consider|visualize
possible|feasible|achievable|attainable|doable|probable
should be|ought to be|needs to be|must be|really should be|need to be
making|creating|producing|generating
responsible for|accountable for
prior to|before
previous|prior|earlier|preceding
past|previous
before|prior to|just before|ahead of
today|these days|right now|nowadays|currently|now
the next|the following|the subsequent
after|following|right after|soon after|immediately after|just after
without|with out|without having|with no|devoid of|without the need of
end|finish
under|below|beneath
always|usually|often|constantly|generally|normally
all the|all of the|each of the
at all times|all the time|constantly
frequently|often|regularly
regularly|frequently|routinely|often|on a regular basis|consistently
often|frequently|usually|typically|generally|normally
continuously|constantly
with a|having a|using a
when it comes to|with regards to|in terms of|in relation to|in regards to|on the subject of
in terms of|when it comes to|with regards to
subject|topic
is one of the|is among the|is amongst the
among|amongst
likely|most likely|probably
some of the|a few of the|a number of the|several of the|many of the
probably|most likely|almost certainly|possibly|in all probability|likely
crucial|essential|vital|critical|important
vital|important|essential|crucial|very important
you are|you're|you might be|you happen to be|you will be|that you are
you'll|you will|you are going to
on a regular basis|regularly|frequently
might be|may be|could be
huge|massive|large|enormous|big|substantial
cash|money
besides|in addition to|apart from
keep in mind|bear in mind|remember|take into account
remember that|keep in mind that|do not forget that|understand that
understand|comprehend|realize|recognize|fully grasp|have an understanding of
the fact that|the truth that
it is|it's|it really is|it truly is|it can be|it is actually
important|essential|crucial|critical|significant|vital
very|extremely|really|quite|incredibly|pretty
you will|you'll|you are going to|you may|you might|you can
need|require|want|need to have|will need|have to have
number|quantity
numerous|many|several|quite a few|a lot of|various
however|nevertheless|nonetheless|even so|on the other hand|having said that
again|once more|once again
people|individuals|folks|men and women|persons|people today
lots of|plenty of|a lot of|a great deal of|numerous
have to|need to|must
so that|to ensure that|in order that
you can|you are able to|you'll be able to|it is possible to|you may|you could
effort|work
way to|method to|approach to|strategy to|technique to|solution to
you could|you can|you may|you might|you could possibly
to have|to possess
ability|capability|capacity|potential
as a result of|because of
because of|due to|as a result of
make sure that|ensure that|be sure that|make certain that
be sure|make sure|be certain|make certain
there are lots of|there are many
for you|for you personally
if you want to|if you wish to|in order to|if you'd like to
if you|in the event you|should you|in case you|when you|for those who
wish|want
a great|an excellent|a fantastic|a terrific|an incredible|an awesome
quite|fairly|really|very|rather|pretty
want to|wish to|need to|desire to|would like to|choose to
would be|could be|will be
best|very best|greatest|ideal|finest|most effective
definitely|certainly|undoubtedly|absolutely|surely|unquestionably
effective|efficient|successful|powerful|productive|helpful
the best|the very best|the most effective|the top|the ideal|the most beneficial
significant|substantial|considerable|important
you would|you'd
you want|you would like|you need|you desire|you wish|you'd like
you need|you'll need|you will need|you may need
to begin|to start
to start|to begin
looking|searching|seeking|hunting
a bit|a little
time and money|money and time
you may|you might|you could|you could possibly
additionally|in addition|furthermore|moreover|also|on top of that
you might|you may|you could
decision|choice|selection
decide|determine|choose|make a decision
made|produced|created
feel|really feel
you have|you've|you've got|you might have|you may have|you have got
already|currently
become|turn out to be|grow to be|turn into|develop into|come to be
you don't|you do not
haven't|have not
a little|a bit|just a little|somewhat|slightly|a little bit
perform|carry out|execute
most likely|probably
appear|seem
various|numerous|different|a variety of|several|many
types|kinds|varieties|sorts|forms
will be|will probably be|will likely be|is going to be|might be|are going to be
helps|assists|aids
lets you|allows you to
result|outcome
lead to|result in|bring about|cause
allows|enables|permits|makes it possible for
allow you to|permit you to|let you|enable you to
let you|allow you to
many people|lots of people|a lot of people|many individuals|lots of individuals|many of us
how much|just how much
what is|what's|what exactly is
what's|what is
we have|we've|we've got
we are|we're
high quality|top quality|premium quality|good quality
quality|high quality|top quality|good quality|excellent|high-quality
spend|invest|devote|commit
so much|a lot
offer|provide|supply|offer you|present|give
protect|shield|safeguard|defend|guard
more|much more|a lot more|far more|additional|extra
select|choose|pick
last|final
as long as|so long as|provided that
to keep in mind|to bear in mind|to remember
bear in mind|keep in mind
go to|visit
good|great|excellent|very good|fantastic|superior
to do|to complete|to accomplish|to perform
research|study|analysis|investigation
analysis|evaluation
choosing|selecting|picking|deciding on|deciding upon|picking out
the proper|the correct
the right|the proper|the correct|the best|the appropriate|the ideal
selecting|choosing|picking|deciding on
aware|conscious
concentrate on|focus on
attention|interest|focus|consideration
searching for|looking for|trying to find
looking for|searching for|trying to find|seeking|in search of|on the lookout for
much|a lot|significantly|considerably|substantially|a great deal
party|celebration
4|four
period of time|time period|time frame
keeping|maintaining
to keep|to help keep|to maintain
they have|they've
generally|usually|typically|normally|commonly|frequently
do not have|don't have
could be|might be|could possibly be|may be|may very well be
they'll|they will
there is no|there isn't any|there's no|there is absolutely no
there are plenty of|there are many
variety|selection|assortment|range|wide variety
selection|choice
wonderful|fantastic|great|superb|amazing|excellent
thing|factor|point|issue
lifestyle|way of life|life-style|life style
color|colour
security|safety
safety|security
few|couple of|handful of
focus|concentrate
once|as soon as|when|after
popular|well-liked|well-known|common|well known|preferred
suitable|appropriate
option|choice|alternative|selection|solution
advantage|benefit
benefit|advantage
clothing|clothes
clothes|garments|clothing
details|particulars|specifics|information|facts
you've|you have
there is a|there's a
outdoor|outside
outside|outdoors
nearly|almost|practically
he is|he's
that have|which have
that has|which has
that are|which are|which can be|which might be|that happen to be
should|ought to|must|need to|really should|should really
were|had been|have been
have been|happen to be|have already been
should not|shouldn't
key|important|crucial|essential
referred to as|known as
also known as|also referred to as|also called
sometimes|occasionally|at times|often|from time to time|in some cases
called|known as|referred to as|named
questions|concerns|queries|inquiries
issues|problems|concerns|troubles|difficulties|challenges
to find|to locate|to discover|to seek out
most of|the majority of
most people|many people|a lot of people|most of the people|the majority of people
general|common|basic
family|family members|loved ones|household
family members|members of the family
food|meals
choose from|select from|pick from
finding|discovering|locating|obtaining|acquiring|getting
expect|anticipate|count on
maintaining|sustaining|preserving|keeping
is not|isn't|just isn't|is just not|will not be
isn't|is not
kind of|type of|sort of|form of
sort of|kind of
seems|appears
time to|time for you to
it will|it'll|it's going to|it is going to|it can
thought|believed
considered|regarded as|deemed|regarded|viewed as|thought of
is the|will be the|may be the|would be the|could be the|is definitely the
first|initial|very first|1st|initially
simple|easy|straightforward|basic|uncomplicated|very simple
known|recognized|identified
picking|choosing|selecting
correct|right|appropriate
web|internet|net
internet|web|world wide web|net|online|world-wide-web
less|much less|significantly less
attempt|try
trying|attempting
little|small|tiny
short|brief|quick
nothing|absolutely nothing|nothing at all|practically nothing
for this reason|because of this
rising|increasing
popularity|recognition|reputation
is an|is definitely an
excellent|superb|outstanding|exceptional|great|fantastic
is a great|is a superb|is a good|is an excellent
is a|is really a|is actually a|can be a|is often a|is usually a
part|component|element|portion|aspect
major|significant|main|key|big|important
factor|aspect|element|issue
component|element
useful|helpful|beneficial|valuable
if you want|if you would like|if you'd like|if you need
used|utilized|employed|utilised|applied|made use of
effect|impact
affect|impact|have an effect on|influence
impact|influence|effect
provide|offer|supply|give|present|deliver
long|lengthy|extended
at least|a minimum of|at the very least|at the least|no less than
for a|to get a|for any
improving|enhancing
extremely|very|incredibly|really|particularly|exceptionally
are not|aren't|usually are not|will not be|are certainly not|are usually not
positive|good|optimistic|constructive
soon|quickly
are you|are you currently
can you|are you able to
a few|a couple of|several|a number of|some|a handful of
things|issues|items|factors|points
and you|and also you
what kind of|what sort of|what type of
men|males|guys
men and women|women and men
summer|summer time|summer season
opportunity|chance
chance|opportunity|likelihood|possibility
and a|along with a|as well as a|plus a|and also a|in addition to a
approach|method|strategy
place|location|spot
starting|beginning
success|achievement|good results|accomplishment|results
perfect|ideal|excellent|best|great|fantastic
call|contact|get in touch with
full|complete
a good|a great|an excellent|a superb|a fantastic|a very good
article|post|write-up|report|short article
believe|think
consider|think about|contemplate|take into account|look at|take into consideration
true|accurate|correct
rapidly|quickly|swiftly
over|more than
places|locations|areas
every|each|each and every|every single|just about every
through|via|by means of|by way of
throughout|all through
during|throughout|in the course of|for the duration of|through
love|adore|really like|enjoy|appreciate|like
immediate|instant|quick
realize|understand|recognize|comprehend
due to|because of|as a result of|on account of|resulting from|as a consequence of
as it|because it|since it
correctly|properly|appropriately
together|with each other|collectively
along with|together with|in addition to|as well as|in conjunction with
own|personal
their own|their very own
cut|reduce
the use of|the usage of
despite|regardless of|in spite of
even though|although|despite the fact that
although|even though|though|despite the fact that|while
even if|even when|even though
confidence|self-confidence|self-assurance
and then|and after that|after which|then
like to|prefer to
fit|match
safe|secure|protected
eat|consume
eating|consuming
for free|at no cost|free of charge|totally free
cost|price|expense
given|offered|provided
being|becoming|getting
occasionally|sometimes
boost|increase|enhance
improve|enhance|boost|increase|strengthen
enhance|improve|boost
support|assistance|help
holiday|vacation
vacation|holiday|trip|getaway
shopping|buying|purchasing
buy|purchase|acquire|get|obtain|invest in
fun|enjoyable|entertaining|exciting
having|getting|possessing|obtaining
in fact|actually|in reality|the truth is|in truth|in actual fact
actually|really|truly|in fact|essentially|basically
different|various|distinct|diverse|unique|distinctive
another|an additional|yet another|one more|a different|a further
country|nation
directly|straight
knowledge|understanding|information|expertise|know-how
truly|really|genuinely|actually|definitely
everything|every thing|every little thing|almost everything|anything|all the things
finally|lastly|ultimately
mean|imply
appears|seems
keep|maintain|preserve|hold|retain
control|manage|handle
contact|get in touch with|make contact with|speak to
relax|unwind|loosen up
better|much better|far better|greater|superior|improved
take advantage of|make the most of|benefit from|reap the benefits of
determine|figure out|decide|establish|ascertain|identify
gift|present
giving|providing
allowing|permitting|enabling
more than|greater than